{
  "tile_size": 32,
  "spawn": [
    32,
    32
  ],
  "legend": {
    ".": {
      "name": "grass",
      "solid": false,
      "color": [
        55,
        130,
        73
      ]
    },
    ",": {
      "name": "wild grass",
      "solid": false,
      "color": [
        75,
        153,
        86
      ]
    },
    "~": {
      "name": "water",
      "solid": true,
      "color": [
        43,
        91,
        151
      ]
    },
    "#": {
      "name": "stone wall",
      "solid": true,
      "color": [
        90,
        91,
        95
      ]
    },
    "=": {
      "name": "road",
      "solid": false,
      "color": [
        128,
        112,
        84
      ]
    },
    "T": {
      "name": "tree",
      "solid": true,
      "color": [
        39,
        88,
        50
      ]
    },
    "R": {
      "name": "rock",
      "solid": true,
      "color": [
        102,
        106,
        112
      ]
    }
  },
  "tiles": [
    "####################################################################################################",
    "#..................................................................................................#",
    "#..................................................................................................#",
    "#..................................................................................................#",
    "#..................................................................................................#",
    "#..................................................................................................#",
    "#..................................................................................................#",
    "#..................................................................................................#",
    "#..................................................................................................#",
    "#..................................................................................................#",
    "#..................................................................................................#",
    "#..................................................................................................#",
    "#..................................................................................................#",
    "#..................................................................................................#",
    "#..................................................................................................#",
    "#..................................................................................................#",
    "#..................................................................................................#",
    "#..................................................................................................#",
    "#..................................................................................................#",
    "#..................................................................................................#",
    "#..................................................................................................#",
    "#..................................................................................................#",
    "#..................................................................................................#",
    "#..................................................................................................#",
    "#..................................................................................................#",
    "#..................................................................................................#",
    "#..................................................................................................#",
    "#..................................................................................................#",
    "#..................................................................................................#",
    "#..................................................................................................#",
    "#..................................................................................................#",
    "#..................................................................................................#",
    "#..................................................................................................#",
    "#..................................................................................................#",
    "#..................................................................................................#",
    "#..................................................................................................#",
    "#..................................................................................................#",
    "#..................................................................................................#",
    "#..................................................................................................#",
    "#..................................................................................................#",
    "#..................................................................................................#",
    "#..................................................................................................#",
    "#..................................................................................................#",
    "#..................................................................................................#",
    "#..................................................................................................#",
    "#..................................................................................................#",
    "#..................................................................................................#",
    "#..................................................................................................#",
    "#..................................................................................................#",
    "#..................................................................................................#",
    "#..................................................................................................#",
    "#..................................................................................................#",
    "#..................................................................................................#",
    "#..................................................................................................#",
    "#..................................................................................................#",
    "#..................................................................................................#",
    "#..................................................................................................#",
    "#..................................................................................................#",
    "#..................................................................................................#",
    "#..................................................................................................#",
    "#..................................................................................................#",
    "#..................................................................................................#",
    "#..................................................................................................#",
    "#..................................................................................................#",
    "#..................................................................................................#",
    "#..................................................................................................#",
    "#..................................................................................................#",
    "#..................................................................................................#",
    "#..................................................................................................#",
    "#..................................................................................................#",
    "#..................................................................................................#",
    "#..................................................................................................#",
    "#..................................................................................................#",
    "#..................................................................................................#",
    "#..................................................................................................#",
    "#..................................................................................................#",
    "#..................................................................................................#",
    "#..................................................................................................#",
    "#..................................................................................................#",
    "#..................................................................................................#",
    "#..................................................................................................#",
    "#..................................................................................................#",
    "#..................................................................................................#",
    "#..................................................................................................#",
    "#..................................................................................................#",
    "#..................................................................................................#",
    "#..................................................................................................#",
    "#..................................................................................................#",
    "#..................................................................................................#",
    "#..................................................................................................#",
    "#..................................................................................................#",
    "#..................................................................................................#",
    "#..................................................................................................#",
    "#..................................................................................................#",
    "#..................................................................................................#",
    "#..................................................................................................#",
    "#..................................................................................................#",
    "#..................................................................................................#",
    "#..................................................................................................#",
    "####################################################################################################"
  ],
  "entities": []
}
